111111
10P001
1111C1
1E0001
111111
