11111111
10P000C1
11110001
1110C011
1E000C11
11111111
