1111111111111
1010000X000C1
10000111110C1
1P0011E000001
1111111111111