111111111111111111111
1E000000000X000C000C1
1C1001C00100100100101
1010010001001C0100101
1P0000000C00C00000001
111111111111111111111
