11111111111111111111
11111100C000000000C1
11111111101111111111
1E00C0000000X0000011
11111110000000001111
1111111P0011110000C1
11111111111111111111
